7
7
5 3 2 2 1 4 3
2 1 0 1 5 3 3
1 6 1 4 3 1 1
2 5 1 4 3 6 1
2 2 3 3 1 1 5
2 1 5 6 1 6 1
2 6 2 4 1 5 1